18 18
#,0,0,0,0,#,0,#,#,0,0,#,#,0,0,0,0,0
#,0,#,0,0,#,0,#,#,0,0,#,#,0,0,0,0,0
#,0,#,0,0,#,0,#,#,0,0,#,#,0,0,0,0,0
#,0,0,0,0,#,0,#,#,0,0,#,0,0,0,0,0,0
#,#,0,0,0,#,0,0,0,0,0,0,0,0,0,0,0,0
0,0,0,#,0,#,0,#,#,0,0,0,0,0,#,0,0,0
0,0,#,#,0,#,0,0,0,#,0,0,#,0,#,0,0,0
0,#,#,#,0,0,0,0,#,0,0,0,#,0,#,0,0,0
0,0,#,#,#,#,#,0,#,#,0,0,#,0,#,0,0,0
0,0,0,0,#,#,0,0,#,0,0,0,0,0,#,0,0,0
0,0,0,0,#,#,0,0,0,#,0,0,#,0,#,0,0,0
0,0,0,0,#,0,0,0,0,0,0,0,0,0,0,0,0,0
0,0,0,0,0,0,0,0,#,0,0,0,0,#,0,0,0,0
0,0,0,0,#,0,0,0,0,0,0,0,0,0,#,0,0,0
0,0,0,0,0,0,0,0,#,0,0,0,#,0,0,0,0,0
0,0,0,0,0,0,0,0,#,0,0,0,#,0,0,0,0,0
0,0,0,0,0,0,0,0,#,0,0,0,#,0,0,0,0,0
0,0,0,0,0,0,0,0,#,0,0,0,#,0,0,0,0,0
1
0 1
17 17
