14 14
#,0,0,0,0,#,0,#,#,0,0,#,0,0
#,0,0,0,0,#,0,#,#,0,0,#,0,0
#,#,0,0,0,#,0,0,0,0,0,0,0,0
0,0,0,#,0,#,0,#,#,0,0,0,0,0
0,0,#,#,0,#,0,0,0,#,0,0,#,0
0,#,#,#,0,0,0,0,#,0,0,0,#,0
0,0,#,#,#,#,#,0,#,#,0,0,#,0
0,0,0,0,#,#,#,0,0,#,0,0,0,0
0,0,0,0,#,#,0,0,0,#,0,0,#,0
0,0,0,0,#,0,0,0,0,0,0,0,0,0
0,0,0,0,0,0,0,0,#,0,0,0,0,#
0,0,0,0,#,0,0,0,0,0,0,0,0,0
0,0,0,0,0,0,0,0,#,0,0,0,#,0
0,0,0,0,0,0,0,0,#,0,0,0,#,0
1
0 1
13 13
