10 10
88, 0, 0, 0, 0,88, 0,88,88, 0
88,88, 0, 0, 0,88, 0, 0, 0, 0
 0, 0, 0,88, 0,88, 0,88,88, 0
 0, 0,88,88, 0,88, 0, 0, 0,88
 0,88,88,88, 0, 0, 0, 0,88, 0
 0, 0,88,88,88,88,88, 0,88,88
 0, 0, 0, 0,88,88, 0, 0,88, 0
 0, 0, 0, 0,88,88, 0, 0, 0,88
 0, 0, 0, 0,88, 0, 0, 0, 0, 0
 0, 0, 0, 0, 0, 0, 0, 0,88, 0
1
0 1
9 9
