14 14
88, 0, 0, 0, 0,88, 0,88,88, 0, 0,88, 0, 0
88, 0, 0, 0, 0,88, 0,88,88, 0, 0,88, 0, 0
88,88, 0, 0, 0,88, 0, 0, 0, 0, 0, 0, 0, 0
 0, 0, 0,88, 0,88, 0,88,88, 0, 0, 0, 0, 0
 0, 0,88,88, 0,88, 0, 0, 0,88, 0, 0,88, 0
 0,88,88,88, 0, 0, 0, 0,88, 0, 0, 0,88, 0
 0, 0,88,88,88,88,88, 0,88,88, 0, 0,88, 0
 0, 0, 0, 0,88,88, 0, 0,88, 0, 0, 0, 0, 0
 0, 0, 0, 0,88,88, 0, 0, 0,88, 0, 0,88, 0
 0, 0, 0, 0,88, 0, 0, 0, 0, 0, 0, 0, 0, 0
 0, 0, 0, 0, 0, 0, 0, 0,88, 0, 0, 0, 0,88
 0, 0, 0, 0,88, 0, 0, 0, 0, 0, 0, 0, 0, 0
 0, 0, 0, 0, 0, 0, 0, 0,88, 0, 0, 0,88, 0
 0, 0, 0, 0, 0, 0, 0, 0,88, 0, 0, 0,88, 0
1
0 1
13 13
