10 10
# 0 0 0 0 # 0 # # 0
# # 0 0 0 # 0 0 0 0
0 0 0 # 0 # 0 # # 0
0 0 # # 0 # 0 0 0 #
0 # # # 0 0 0 0 # 0
0 0 # # # # # 0 # #
0 0 0 0 # # 0 0 # 0
0 0 0 0 # # 0 0 0 #
0 0 0 0 # 0 0 0 0 0
0 0 0 0 0 0 0 0 # 0
1
0 1
9 9
