N M Sx Sy
. . # . .
. # . . .
. . . # #
. # . . .
