5 7 2 3
. . . # . . .
. # . # . # .
. . . . . . .
# # . # . # .
. . . # . . .
